11111111111111111111111111111
10000000000001110000000000001
10111101111101110111110111101
10111101111101110111110111101
10110000000000000000000001101
10110111101111111110111101101
10110111101111111110111101101
10000110000001110000001100001
11110110111101110111101101111
11110110111101110111101101111
10000000000000000000000000001
10111111101111011110111111101
10111111101100000110111111101
10111111101100000110111111101
10001100001100000110000110001
11101101101100000110110110111
11101101101111111110110110111
10000001100000000000110000001
10111101101111111110110111101
10111101101111111110110111101
10110001100001110000110001101
10110111101101110110111101101
10110111101101110110111101101
10000000001100000110000000001
11110110111101110111101101111
11110110111101110111101101111
10000110000001110000001100001
10111110110111111101101111101
10111110110111111101101111101
10000000110000000001100000001
11111111111111111111111111111
